%%%%%%%%%%%%%%%%%%%%%%%%%%%%%%%%%%%%%%
%..............  ....  ..   .......  %
%.%%%..%%%%%%.. %%%%% %%%  %%%%%%%%  %
%.%%...%   %  ..  %%% %%%    %% .... %
%.%%.%.% % % %%%% %%%%%%%%%  %% .%%%%%
%.%%.%.% % % %  P %%  ...... %% .    %
%.%%.%.% % % % %%%%%  %%%    %%%%%% .%
%.%%.%.% %   %... %%  %%%%  %%% .....%
%.%%.%.% %%%%%%%% %% ....... %% .%%%%%
%.%%.% . %%..................%%......%
%..%.%%..... %.......%    %% %%      %
%......%%%%%% %% GG%%    %%  %%  %%%%%
% %%%%%%      %.......%%%%%  %%      %
%......... %%%%.......%%%%%  %%%%%%  %
%%%%%%%%   %.................%%%%%%  %
%......... %%%%%%%%%%%%%%%%..........%
%%%%%%%%%%%%%%%%%%%%%%%%%%%%%%%%%%%%%%